1 0 0 1 1 1 1 1 1 1 1 1 1 1 1 1
1 0 0 0 0 0 0 0 0 0 0 0 0 0 0 0
1 0 0 0 0 0 0 0 0 0 0 0 0 0 0 1
1 0 0 0 0 0 0 0 0 0 0 0 0 0 0 1
1 0 0 0 0 0 0 0 0 0 0 0 0 0 0 1
1 0 0 0 9 3 3 3 3 10 0 0 0 0 0 1
1 0 0 0 5 1 2 1 1 4 0 0 0 0 0 1
1 0 0 0 5 1 1 1 1 4 0 0 0 0 0 1
1 0 0 0 5 2 1 2 1 4 0 0 0 0 0 1 
1 0 0 0 5 2 1 1 2 4 0 0 0 0 0 1
1 0 0 0 7 6 6 6 6 8 0 0 0 0 0 1
1 1 1 1 1 1 1 1 1 1 1 1 1 1 1 1